      ____           __                          __                                 
     /  _/   ____   / /_  ___    _____  _____   / /_   ____ _   ____    ____ _  ___ 
     / /    / __ \ / __/ / _ \  / ___/ / ___/  / __ \ / __ `/  / __ \  / __ `/ / _ \
   _/ /    / / / // /_  /  __/ / /    / /__   / / / // /_/ /  / / / / / /_/ / /  __/
  /___/   /_/ /_/ \__/  \___/ /_/     \___/  /_/ /_/ \__,_/  /_/ /_/  \__, /  \___/ 
                                                                     /____/         